.P........................B.
............................
............................
1111111111111111111111111111
1DDDDDDDDDDDD11DDDDDDDDDDDD1
1D1111D11111D11D11111D1111D1
1E1111D11111D11D11111D1111E1
1D1111D11111D11D11111D1111D1
1DDDDDDDDDDDDDDDDDDDDDDDDDD1
1D1111D11D11111111D11D1111D1
1D1111D11D11111111D11D1111D1
1DDDDDD11DDDD11DDDD11DDDDDD1
111111D11111011011111D111111
.....1D11111011011111D1.....
.....1D11000000000011D1.....
.....1D110MMMMMMMM011D1.....
111111D110M......M011D111111
W00000D000M......M000D00000W
111111D110M......M011D111111
.....1D110MMMMMMMM011D1.....
.....1D11000000000011D1.....
.....1D11011111111011D1.....
111111D11011111111011D111111
1DDDDDDDDDDDD11DDDDDDDDDDDD1
1D1111D11111D11D11111D1111D1
1D1111D11111D11D11111D1111D1
1EDD11DDDDDDDPPDDDDDDD11DDE1
111D11D11D11111111D11D11D111
111D11D11D11111111D11D11D111
1DDDDDD11DDDD11DDDD11DDDDDD1
1D1111111111D11D1111111111D1
1D1111111111D11D1111111111D1
1DDDDDDDDDDDDDDDDDDDDDDDDDD1
1111111111111111111111111111
C..........................I
............................
